11111111111111111111
10E000100D000101D001
1000C000C00110000101
10D000P00110000100C1
10E010000C01000000C1
100010000C0110D001C1
1000000010000C000CC1
1C00C0E00000D0110001
100010000C0C00C01C01
10E010000C0C0C1CE001
11111111111111111111
