11111
100C1
1P0D1
1CPE1
111111
